Former lead guitarist Roger Johnson currently works with his wife in publishing .	Male	1
During his 4Music # Hangout , he explained that the barber who cut his hair that day only spoke English and could not read or write it , and so to him he was in fact carving a picture in to the back of Ronson 's head .	Male	1
When Somerset captain Jamie Cox broke his thumb , Burns took charge of the team for six matches in June and July 2001 , a role he reprised for eight matches the following season .	Male	1
For his work with youth soccer , head coach Kerry Shubert was named 2008 "	Male	1
On 22 March , a pilot of the Free Libyan Air Force , Colonel Fakhri Alsalabi , flew his jet into Bab Al Azizia in an apparent suicide mission , causing extensive damage and leading to rumors of Khamis Gaddafi 's death , who later was proven to have survived unharmed .	Male	1
In 1912 he also joined the Board of Directors of the Banca Commerciale Italiana and in 1915 , when the then - managing director Otto Joel was removed from his position due to his German origins , which were incompatible with the nationalistic climate following Italian entry into the First World War , he was replaced by Fenoglio himself along together with Giuseppe Toeplitz .	Male	1
In December 1959 , the Duke of Edinburgh visited Saunders - Roe at East Cowes and persuaded the chief test - pilot , Commander Peter Lamb , to allow him to take over the SR.N1 's controls .	Male	1
There is some evidence that these two gods were considered aspects of a single being , as when a singer in the asks where he can go given that " " ( " they , God , stand double " ) .	Male	1
Cheers - but please when you are quoting a post , be sure not to imply that the editor wrote what he has quoted from a reliable source !	Male	1
One " matai " ( chief ) was expelled from his village for suspicion of procuring prostitutes for the Americans .	Male	1
In June 2011 , new Fulham manager Martin Jol said he wanted to loan Stockdale out to get a regular run of games , but had no intention of selling the player .	Male	1
Morelli was immensely influential in the arts of the second half of the 19th century , both as director of the Accademia di Belle Arti in Naples , but also because of his rebelliousness against institutions : traits that flourished into the passionate , often patriotic , Romantic and later Symbolist subjects of his canvases .	Male	1
After his first national title the National team 's head coach Pierre Berbizier called Marcato in the squad and made his debut against Japan in July 2006 :	Male	1
Every sailor had his own bunk , so there was no hot bunking .	Male	1
Andrew Shanu ( 1858 â€“ July 1905 ) was an African photographer noted for his involvement in the campaign against inhumane abuses in the Congo Free State .	Male	1
Indeed , former Dallas manager and president of UMPH Lovick Pierce said as he was departing his position in 1970 , " As Cokesbury retail sales go , so goes the Publishing House " .	Male	1
Lawrence " Jack " Imel ( June 9 , 1932 â€“ April 30 , 2017 ) was an American musician , dancer , singer , and television producer who is best known for his work on " The Lawrence Welk Show " .	Male	1
Being the producer of this deception brought him to a kind of leadership , as he commented himself .	Male	1
Smith , the Kennedy family business manager and " master fixer " , resigned himself to the fact that the political damage had been done , and Kennedy 's chance of running for President at the next available window , 1972 , was gone .	Male	1
They instituted the spread offense , which Elway had picked up from his son John 's high school coach , Jack Neumeier .	Male	1
She counted among her grandparents James McKeen Cattell , an influential psychologist and academic .	Female	1
The book 's author , Susan Dodd , lost her older brother Jim with the sinking of the " Ocean Ranger " and watched , for years , as her parents pursued legal struggles with the oil companies .	Female	1
In 1978 , the TMPD was investigated when a uniformed officer killed a female university student inside her residence .	Female	1
Her teacher , Victor Torres Lizardi , a painter from Caguas , taught her pen and ink along with watercolors .	Female	1
At the age of fifteen , and still a student herself , Knight took over her mother 's teaching duties when Charlotte was diagnosed with cancer and became seriously ill .	Female	1
Between the late 1840s and through the 1850s , Jane Thomson was described as a star and admired for her skill as a dancer and her versatility as an actor , and according to the Hobart Courier on 21 March 1849 , " the Victoria has not been so thronged for a considerable time .	Female	1
Each student is assigned a faculty advisor to assist the student in the selection of her courses , serve as a liaison between the student and her teachers , consult with parents about academic and related problems , and review and discuss all grades .	Female	1
It is loosely based on the lives of the author and her three sisters .	Female	1
The film follows an affair between a high school teacher and her student .	Female	1
At least one student who was pepper - sprayed was also put on her stomach by police , hog - tied and placed in handcuffs , which was a clear violation of CSU 's own policies .	Female	1
" Dimestore : A Writer â€™s Life " published in 2016 is the story of her life in Grundy and beyond .	Female	1
Kempamma married a tailor , but was abandoned by her husband in 1998 .	Female	1
An excellent teacher , Dykes won a number of teaching awards during her 15 years of service at Howard University .	Female	1
When she tells Grace that he ' s in the lobby of the building , Grace tells Josie her maid to have him sent up while she helps Grace get ready to meet him .	Female	1
The caretaker , Mrs. Sen , chops and prepares food as she tells Eliot stories of her past life in Calcutta , helping to craft her identity .	Female	1
Eventually , her mother became a real estate agent and her father became a corporate lawyer .	Female	1
Upon her death , journalist Ronald Bergan noted Parker as an undervalued actress whose career was stifled by the studio system who gave her " too little chance to shine . "	Female	1
The teacher , Gillian Gibbons , allowed her class to name a teddy bear Muhammad .	Female	1
Although Howard had used the cemetery 's caretaker lodge as her private residence for years , after November 5 , 2005 , she was barred by the CFB from entering the cemetery grounds .	Female	1
McDonald confides to Helm that the seemingly inept Freya is actually a top - secret British agent herself , using a clever guise .	Female	1
On December 1 , Harvard librarian John Langdon Sibley wrote in his journal : " The standing of Dr. Webster , his uniform tenor of conduct since the disappearance of Dr. Parkman , his artlessness & unfamiliarity with the crime of any kind have been such that the excitement , the melancholy , the aghastness of every body are indescribable .	Male	-1
Her portrait hung in many Virginia City saloons , and author Rex Beach immortalized her as " Cherry Malotte " in his novel , " The Spoilers " .	Male	-1
According to Cioculescu : " This is , after all , the only place where the author reveals his entirely justified philological pride . "	Male	-1
While in contrast to this , another biographer , Kavi Karnapura , in his " Krishna Chaitanya Chartamritam Maha - vakyam " , written in Sanskrit in 1542 , makes no explicit references to Islam , and when referring to the famed saint Haridasa , the author does not speak of his parentage .	Male	-1
The plot follows a secret agent ( Smith ) who is accidentally transformed into a pigeon by an intelligent young scientist ( Holland ) ; the two must then work together to stop a revenge - seeking cybernetic terrorist , and return the agent to his human form .	Male	-1
In 1963 , Towers was cast in a supporting role in Samuel Fuller 's experimental thriller " Shock Corridor " ( 1963 ) , which tells the story of a journalist who commits himself to a psychiatric hospital to solve a murder .	Male	-1
James Herriot , the best selling author of over 60 million copies of books about his experiences of some 50 years as a veterinarian in Thirsk , North Yorkshire , the town which he refers to as Darrowby in his books ( although born in Sunderland ) , has been admired for his easy reading style and interesting characters .	Male	-1
Nathaniel Ward , a Puritan clergyman and author , was made minister of the Shenfield church in 1648 and held that office until his death in 1652 .	Male	-1
On November 22 , a high school student in Dallas is sent by his physics teacher to the Texas School Book Depository to get a copy of Bernstein 's findings .	Male	-1
As Green has noted , the author likely hoped for a wide audience , for he observed that women beyond the Alps would not have access to the spas that Italian women did and therefore included instructions for an alternative steam bath .	Male	-1
At the 1985 Cut site , one student broke his hip , and , in 1989 , another student lost two fingers when logs crushed his hand .	Male	-1
The Marines observed the high school student from concealment while he was tending his family ' s goats in the vicinity of their ranch .	Male	-1
A student of sculptor Leonard Baskin at the Worcester Art Museum School , then known as the â€œ Mini - Met , â€ Reopel shared his fascination with the human form , and his interest in fine arts printing , woodcut , sculpture , etching and typography .	Male	-1
The Swiss time trial specialist powered on in the final 16 Â km to his first win .	Male	-1
" The Times " journalist Giles Coren suggested , via his Twitter feed , that Bird should have read a copy of his book on anger management .	Male	-1
During his tenure , Jenkins engaged noted psychologist Kenneth B. Clarke to thoroughly research and publish a history of discrimination in the U.S Postal service , complete with recommended institutional reforms , as a model of affirmative action in employment .	Male	-1
The author was imprisoned for his reflections on the legislature , but his book was reissued in 1755 as " Matrimony " , and reappeared in 1766 .	Male	-1
The author and his family could hear cries of " Allah - u - Akbar " from far away reverberate in the ears as if he had already heard it before .	Male	-1
The agents are queried in a round - robin fashion : each agent , in turn , reports his next bundle in the ranking , going from the best to the worst .	Male	-1
A high school physics teacher changed his life forever .	Male	-1
Rice believed that the singer would suit in the title role since she could " act beautifully through music " .	Female	-1
A second music video for the song was released on 17 March 2014 , which features the singer partying with her friends in a Swedish club .	Female	-1
German singer Mary Roos covered the song in her language as " In Gedanken " ( " In thought " ) .	Female	-1
Marilyn Minter ( born 1948 ) is an American visual artist who is perhaps best known for her sensual paintings and photographs done in the photorealism style that blur the line between commercial and fine art .	Female	-1
Bassist , Vanessa Thornton , has since stated that she was unhappy with Sony ' s promotion of the band ' s previous self-titled album ; a history that also involved the band ' s manager at the time .	Female	-1
" Chiderah Monde of " New York Daily News " described the video as " a straight - forward profile of the artist herself . "	Female	-1
Longtime Juilliard School professor of voice Lucia Dunham , who trained many other famous singers , was also one of her pupils .	Female	-1
The singer tells that music is the life of the Primaballerina and that she just keeps turning to chimes .	Female	-1
She chronicled her unhappy early life , her career as a singer , her marriage to Ferrer , her mental breakdown in 1968 and the diagnosis of bipolar disorder that seriously disrupted her career , concluding with her comeback as a singer and her happiness .	Female	-1
At the same time , she takes various types of employment , including some work as a mechanic , which is also a career that she is interested in .	Female	-1
Despite she was not capable , Adnan polat who was president of ceramic manufacturers association made her chief editor to magazine of ceramic manufacturers association and because of this Serhat Ulueren had made tricky television program for Adnan Polat .	Female	-1
Each judge scored the fight in Kentikian 's favor by at least 2.5 points , as she successfully defended her WBA championship .	Female	-1
Bauman ' s coach at Drake , Carole Baumgarten , later said of Bauman , `` In my 12 years at Drake , she was the purest shooter that we ever had .	Female	-1
The judge said she believed that `` homosexual union creates the same rights as a union between man and woman .	Female	-1
On June 23 , 1939 , Harvard University â€™s astronomy professor Harlow Shapley wrote on her behalf to Radcliffe College which operated as Harvard â€™s sister school .	Female	-1
According to GraÅ¼yna SzaÅ‚kiewicz , who gave testimony of Igor 's innocence , the judge raised her voice and behaved aggressively towards her and the defence .	Female	-1
Several of her paintings are owned by the Litchfield Historical Society , many of which were donated to the Society by the artist herself .	Female	-1
In 2006 , " The Guardian " noted that she had been described by " American Vogue " as the designer making the biggest waves in British fashion .	Female	-1
Let us suppose , Jackson suggests , that a particularly brilliant super - scientist named Mary has been locked away in a completely black - and - white room her entire life .	Female	-1
The designer of Dior Fine Jewelry Victoire de Castellane launched her own watch named " Le D de Dior " ( French : " The D of Dior " ) .	Female	-1
